تحقیقات	N_PL	
انجام	N_SING	
شده	V_COP	
توسط	P	
پژوهشگران	N_PL	
اسپانیایی	ADJ	
روی	P	
عادات	N_PL	
غذایی	ADJ	
۱۲	NUM	
هزار	NUM	
و	CON	
۵۹	NUM	
فرد	N_SING	
دانشگاهی	ADJ	
نشان	N_SING	
داده	V_PP	
است	V_COP	
افرادی	N_PL	
که	CON	
چربی‌های	N_PL	
ترانس	N_SING	
زیاد	ADJ	
مصرف	N_SING	
می‌کنند	V_PRS	
۵۰	NUM	
درصد	N_SING	
بیش	ADJ	
از	P	
سایرین	N_PL	
در	P	
معرض	N_SING	
افسردگی	N_SING	
قرار	N_SING	
دارند	V_PRS	
.	DELM	

