تردیدی	N_SING	
نیست	V_COP	
که	CON	
مردم	N_SING	
کشورمان	N_SING	
در	P	
مقاطع	N_PL	
گوناگون	ADJ	
به‌ویژه	ADJ	
در	P	
ماه‌های	N_PL	
پایانی	ADJ	
سال	N_SING	
گذشته	ADJ	
با	P	
حضور	N_SING	
آگاهانه	ADJ	
در	P	
راهپیمایی	N_SING	
۲۲	NUM	
بهمن	N_SING	
و	CON	
انتخابات	N_PL	
نهمین	ADJ_SUP	
دوره	N_SING	
مجلس	N_SING	
شورای	N_SING	
اسلامی	ADJ	
،	DELM	
هوشیاری	N_SING	
و	CON	
وظیفه‌شناسی	N_SING	
خویش	PRO	
در	P	
دفاع	N_SING	
از	P	
آرمان‌های	N_PL	
انقلاب	N_SING	
را	CLITIC	
به	P	
رخ	N_SING	
جهانیان	N_PL	
کشیده‌اند	V_PP	
و	CON	
از	P	
همین	DET	
روست	V_COP	
که	CON	
نظام	N_SING	
جمهوری	N_SING	
اسلامی	ADJ	
توانسته	V_PP	
است	V_COP	
در	P	
عرصه‌های	N_PL	
جهانی	ADJ	
بخصوص	CON	
در	P	
مذاکرات	N_PL	
اخیر	ADJ	
هسته‌ای	ADJ	
با	P	
تکیه	N_SING	
بر	P	
این	DET	
پشتوانه	N_SING	
دشمن‌شکن	ADJ	
،	DELM	
حضوری	N_SING	
پرصلابت	ADJ	
داشته	V_PP	
باشد	V_COP	
و	CON	
از	P	
آرمان‌های	N_PL	
ایران	N_SING	
اسلامی	ADJ	
دفاع	N_SING	
کند	V_SUB	
اما	CON	
به	P	
راستی	ADV	
آیا	CON	
مسوولان	N_PL	
نیز	CON	
توانسته‌اند	V_PP	
به	P	
وظایف	N_PL	
خود	PRO	
در	P	
قبال	N_SING	
مردم	N_SING	
-	DELM	
آنگونه	ADV	
که	CON	
شایسته	ADJ	
و	CON	
بایسته	ADJ	
است	V_COP	
-	DELM	
جامه	N_SING	
عمل	N_SING	
بپوشانند	V_SUB	
؟	DELM	
مروری	N_SING	
اجمالی	ADJ	
بر	P	
عملکرد	N_SING	
نهادهای	N_PL	
مسوول	ADJ	
به‌ویژه	ADJ	
در	P	
زمینه	N_SING	
گرانی‌های	N_PL	
اخیر	ADJ	
نشان	N_SING	
می‌دهد	V_PRS	
که	CON	
برخی	PRO	
از	P	
آن‌ها	PRO	
نتوانسته	V_PP	
-	DELM	
و	CON	
یا	CON	
نخواسته	ADJ_INO	
-	DELM	
اند	DELM	
،	DELM	
متناسب	ADJ	
با‌شان	N_PL	
ملت	N_SING	
بزرگ	ADJ	
ایران	N_SING	
به	P	
وظیفه	N_SING	
خویش	PRO	
این	DET	
باره	N_SING	
عمل	N_SING	
کنند	V_SUB	
و	CON	
از	P	
همین	DET	
روست	V_COP	
که	CON	
شاهد	N_SING	
وضعیتی	N_SING	
نابسامان	ADJ	
در	P	
بازار	N_SING	
کالا	N_SING	
و	CON	
خدمات	N_PL	
مورد	P	
نیاز	N_SING	
قشرهای	N_PL	
گوناگون	ADJ	
جامعه	N_SING	
هستیم	V_PRS	
.	DELM	

