گرچه	CON	
بسیاری	ADJ	
از	P	
کارشناسان	N_PL	
تمدید	N_SING	
گارانتی	N_SING	
یک	N_SING	
خودروی	N_SING	
دست	N_SING	
دوم	ADJ	
را	CLITIC	
بیهوده	ADJ	
می‌دانند	V_PRS	
اما	CON	
این	DET	
کار	N_SING	
یکی	PRO	
از	P	
گزینه‌های	N_PL	
پیش	ADV_TIME	
رو	N_SING	
برای	P	
خریداران	N_PL	
این	DET	
خودروها	N_PL	
است	V_COP	
.	DELM	

