بزرگترین	ADJ_SUP	
نمایشگاه	N_SING	
صنعتی	ADJ	
و	CON	
تجاری	ADJ	
جهان	N_SING	
با	P	
حضور	N_SING	
آنگلا	N_SING	
مرکل	N_SING	
صدر	N_SING	
اعظم	ADJ_CMPR	
آلمان	N_SING	
و	CON	
ون	N_SING	
جیابایو	N_SING	
نخست	ADJ	
وزیر	N_SING	
چین	N_SING	
در	P	
شهر	N_SING	
هانوفر	N_SING	
در	P	
شمال	N_SING	
آلمان	N_SING	
گشایش	N_SING	
یافت	V_PA	
.	DELM	

