به	P	
گزارش	N_SING	
خبرگزاری	N_SING	
فارس	N_SING	
،	DELM	
تیم	N_SING	
ملی	ADJ	
والیبال	N_SING	
بانوان	N_PL	
بزرگسال	ADJ	
ایران	N_SING	
که	CON	
خود	PRO	
را	CLITIC	
برای	P	
حضور	N_SING	
در	P	
مسابقات	N_PL	
هشت	NUM	
تیم	N_SING	
برتر	ADJ_CMPR	
آسیا	N_SING	
آماده	ADJ	
می‌کند	V_PRS	
به	P	
دلیل	N_SING	
پر	ADJ	
بودن	N_SING	
سالن‌های	N_PL	
آزادی	N_SING	
در	P	
باشگاه	N_SING	
پیکان	N_SING	
تمرین	N_SING	
می‌کند	V_PRS	
.	DELM	

